111111111111111111111111111111111111111111111111111
1001N0000000000000000000000000000000000000000000001
100000011111000110000000000000000000000000000000001
100000000010000000000000000000000000000000000000001
100000000100000011100000000000000000000000000000001
100000000010000000000000000000000000000000000000001
100011100000000111100000000000000000000000000000001
100000000010000000000000000000000000000000000000001
100000110010011000000000000000000000000000000000001
100000000010000000000000000000000000000000000000001
100000000000000000000000000000000000000000000000001
100000000000000000000000000000000000000000000000001
100000000000000000000000000000000000000000000000001
100000000000000000000000000000000000000000000000001
100000000000000000000000000000000000000000000000001
100000000000000000000000000000000000000000000000001
100000000000000000000000000000000000000000000000001
100000000000000000000000000000000000000000000000001
100000000000000000000000000000000000000000000000001
100000000000000000000000000000000000000000000000001
100000000000000000000000000000000000000000000000001
100000000000000000000000000000000000000000000000001
111111111111111111111111111111111111111111111111111
