NO ./textures/mos_no.xpm
SO ./textures/mos_so.xpm
EA ./textures/mos_ea.xpm
WE ./textures/mos_we.xpm

C 0,201,255
F 227,213,154

111111111111111111111111111111111111111111111111111
100100000001110000000000000000011100000000000000001
100000011111000110000000000000000000000000000000001
100000000010000000000000000000000000000000000000001
100000000100000011100000000000000000000000000000001
100000000010000000000000000000000000000000000000001
100011100000000111100000000000000000000000000000001
100000000010000000000000000000000000000000000000001
100000110010011000000000000000000000000000000000001
100000000010000000000000000000000000000000000000001
111000000000000000000000000000000001000000000000001
1111000000000000000000000S0000000000000000000000001
111110000000000000000000000000000000000000000000001
111111000000000000000000000000000000000000000000001
111111100000000000000000000000000000000000000000001
111111110000000000000000000000000000000000000000011
111111111000000000000000000000000000000000000000001
100000000000000000000000000000000000000000000000011
100000000000000000000000000000000100000000000000111
100000000000000000000000000000000000000000000001111
100000000000000000000000000000000000000000000011111
110000000011100000000000000000111000000000000111111
111111111111111111111111111111111111111111111111111
