11111
10001
10S01
10001
11111
 _  _  _  _  _
|_||_||_||_||_|
|_|( )( )( )|_|
|_|( )(S)( )|_|
|_|( )( )( )|_|
|_||_||_||_||_|
