NO ./textures/saucisse.xpm
SO ./textures/mos_so.xpm
EA ./textures/mos_ea.xpm
WE ./textures/mos_we.xpm

C 0, 201, 255
F 227, 213, 154

   11 111111
 11111100001
11000000N001
100000110001
101010111101
111111111111
