NO ./textures/mos_no.xpm
SO ./textures/mos_so.xpm
EA ./textures/mos_ea.xpm
WE ./textures/mos_we.xpm

C 0, 201, 255
F 227, 213, 154

111111111111111111
110000000000000111
111111110001110011
100000000001100001
100000011100000111
111111111111111111
