SO ./sprites_solong/grass3.xpm
EA ./sprites_solong/bush.xpm

C 1,255,0
WE ./sprites_solong/bush.xpm
NO ./sprites_solong/grass3.xpm
F 255,1,0

11111111 1111111 111111111
10000001110001011100000001
10000000000000000000000001
11111111100000N00011000001
        110000000000111001
        1111111111111 1111
