1111111
  10000001
  10N0001
10000001
  10000001
  11111111
