1111111111
  10000001
1110N00011
1000000111
1110000001
  11111111
