1111111111
101E000001
1000001001
1110000001
1100101111
1000100001
1111111111
