NO ./sprites_solong/no.xpm
SO ./sprites_solong/so.xpm
EA ./sprites_solong/ea.xpm
WE ./sprites_solong/we.xpm

C 0, 201,255
F 227, 213,154

111111111111
100100000001
100000000001
10000S000001
100000000001
111111111111
