    111111
1000000001
10000N0001
1111111111
