NO ./sprite
SO ./sprite
EA ./sprite
WE ./sprite

F 220,100,0
C 225,30,0


   11 111111
  111110N001
 10000000001
100000110001
101010111101
1111111  111 













































