11111111 1111111 111111111
10000000100110001001111111
11111111100000N00011000001
         10000000000010001
         11111111111111111
