NO ./sprites_solong/grass3.xpm
SO ./sprites_solong/grass3.xpm
EA ./sprites_solong/bush.xpm
WE ./sprites_solong/bush.xpm

C 1,255,0
F 255,1,0

111111111111111111
110000000000000111
111111111000111001
10000000W001100001
100000011100000111
111111111111111111
