NO ./sprites_solong/no.xpm
SO ./sprites_solong/so.xpm
EA ./sprites_solong/ea.xpm
WE ./sprites_solong/we.xpm

C 0, 201, 255
F 227, 213, 154

111111111111111111
110000000000000111
111111111000111001
10000W000001100001
100000011100000111
111111111111111111
