        111111111111111111
        100100000000000001
11111111100000011100000001
10000000001100000111111111
11011111 1111111 111111111
