NO ./sprites_solong/grass.xpm
SO ./sprites_solong/grass.xpm
EA ./sprites_solong/grass.xpm
WE ./sprites_solong/grass.xpm

C 102,255,255
F 204,153,102

111111111111111111
110000000000000111
111111111000111001
100000000N01100001
100000011100000111
111111111111111111
