NO ./sprites_solong/grass3.xpm
SO ./sprites_solong/grass3.xpm
EA ./sprites_solong/bush.xpm
WE ./sprites_solong/item1.xpm

F 220,100,0
C 225,0,1


      111111
  111110N001
 10000000001
100000110001
101010111101
1111111  111 













































