NO ./sprites_solong/grass3.xpm
SO ./sprites_solong/grass3.xpm
EA ./sprites_solong/bush.xpm
WE ./sprites_solong/bush.xpm

C 1,255,0
F 255,1,0

        111111111111111111
        110000000000000111
11111111100011100000001111
1000000000110S000111111111
10000000110000011100000001
1111111101111111 111111111
