NO ./sprites_solong/grass3.xpm
SO ./sprites_solong/grass3.xpm
EA ./sprites_solong/bush.xpm
WE ./sprites_solong/bush.xpm

C 1,255,0
F 255,1,0


      111111
  111110N001
 10000000001
100000110001
101010111101
1111111  111      
   11  
