C 1,255,0


SO ./sprites_solong/grass3.xpm
EA ./sprites_solong/bush.xpm
WE ./sprites_solong/bush.xpm
NO ./sprites_solong/grass3.xpm
F 255,1,0

Map bonne
11111111 1111111 111111111
10000001110001011100000001
10000000000000000000000001
11111111100000N00011000001
         10000000000010001
         11111111111111111
         
Map pas bonne
11111111 1111111 111111111
10000000100001001000000001
10000000000000000000000001
11111111100000N00011000001
         10000000000010001
         11111111111111111
