NO ./sprites_solong/grass3.xpm
SO ./sprites_solong/grass3.xpm
EA ./sprites_solong/bush.xpm
WE ./sprites_solong/bush.xpm

C 1,255,0
F 255,1,0

111111111111111111
1100000000P0000111
111111111000111001
10000000N001100001
100000011100000111
111111111111111111
